#############################
#*.........................*#
#.######.###########.######.#
#.....*#.............#*.....#
#.####.#.#####.#####.#.####.#
#....#.#.............#.#....#
#.##.#.#.#####.#####.#.#.##.#
#....#.................#....#
#.##.#.#.#.### ###.#.#.#.##.#
#......#.#.# ! ! #.#.#.#.##.#
#.##.#.#.#.# ! ! #.#.#......#
#.##.#.#.#.#######.#.#.#.##.#
#....#.................#....#
#.##.#.#.#####.#####.#.#.##.#
#....#.#.............#.#....#
#.####.#.#####.#####.#.####.#
#.....*#.............#*.....#
#.######.###########.######.#
#*............@............*#
#############################