#############################
#*.....!...............!...*#
#.######.###########.######.#
#.....*#.............#*.....#
#.####.#.#####.#####.#.####.#
#....#.#......!......#.#....#
#.##.#.#.#####.#####.#.#.##.#
#....#.................#....#
#.##.#.#.#.### ###.#.#.#.##.#
#......#.#.# ! ! #.#.#.#.##.#
#.##.#.#.#.# ! ! #.#.#......#
#.##.#.#.#.#######.#.#.#.##.#
#....#.................#....#
#.##.#.#.#####.#####.#.#.##.#
#....#.#......!......#.#....#
#.####.#.#####.#####.#.####.#
#..!..*#.............#*..!..#
#.######.###########.######.#
#*............@............*#
#############################